rank,club,numOfGame,winScore,win,draw,lose,score,lscore,difference
1,전북,38,81,24,9,5,61,22,39
2,수원,38,67,19,10,9,52,37,15
3,서울,38,58,15,13,10,42,28,14
4,포항,38,58,16,10,12,50,39,11
5,제주,38,54,14,12,12,39,37,2
6,울산,38,50,13,11,14,44,43,1
7,전남,38,51,14,9,15,48,53,-5
8,부산,38,43,10,13,15,37,49,-12
9,성남,38,40,9,13,16,32,39,-7
10,인천,38,40,8,16,14,33,46,-13
11,경남,38,36,7,15,16,30,52,-22
